######################################
#              D                     #
#       t                            #
#                            t       #
#                    T               #
#       T                            #
#                        M           #
#                      S             #
#                                    #
######################################