######################################
#     T                 T        T   #
#       t                            #
#   T                        t       #
#                    T               #
#       T                            #
#                        M           #
#                      S             #
#   D                             T  #
######################################