######################################
#                  t              T  #
#       t                            #
#    D                       t       #
#                    T               #
#       T                            #
#                        M           #
#                      S        T    #
#       t                            #
######################################