######################################
#                       t            #
#       t                            #
#                            t       #
#   T        D       T               #
#       T                            #
#                        M           #
#                      S        T    #
#     t                              #
######################################