######################################
#                         t          #
#       t                            #
#                            t       #
#                                    #
#       t                        D   #
#                        M           #
#   t                  S             #
#                                    #
######################################