#D#######D####D###D######D######D#####
#                                    #
#                                    #
#                                    #
#                                    #
#                                    #
#                                    #
#                                    #
#                 S                  #
#                                    #
#                                    #
#######D########D###########D#####D###
